border_size=1
usage=map

Gs^Fds, Gs^Fds, Gs^Fds, Gs^Fds, Gs^Fds, Gs^Fds, Gs^Fds, Gs^Fds, Gg, Gd, Gd, Gd, Wwt, Wwt, Wwt, Wwt, Wwt, Wwt, Wwt, Gs, Gs, Gs, Gs, Gs, Gs, Gs
Gs^Fds, Gs^Fds, Gs^Fds, Gs^Fds, Gs^Fds, Gs^Fds, Gg, Gg, Gd, Gd, Gd, Gd, Gd, Wwt, Wwt, Wwt, Wwt, Wwt, Gs, Gs, Gs, Gs, Gs, Gs, Gs, Gs
Gs^Fds, Gs^Fds, Gs^Fds, Gs^Fds, Gg, Gg, Gs, Gs, Gd, Gd, Gd, Gd, Gd, Gd, Gd, Wwt, Gs^Br\, Gs, Gs, Gs^Fds, Gs, Gs, Gs^Br/, Gg, Gs, Gs
Gs^Fds, Gs^Fds, Gs^Fds, Gs^Fds, Gs, Gs, Mm, Gs, Gd, Gs^Fds, Gd, Gd, Gd, Gs, Gd, Gd^Br/, Gs^Tfd, Gs^Br\, Gs^Br\, Gs, Gs, Gs^Br|, Gs^Fds, Gs^Fds, Gs^Fds, Gs
Gs^Fds, Gs^Fds, Gd, Gs, Gd, Mm, Mm, Mm, Gd, Gd, Gd, Gd, Gd, Gd, Mm, Gd, Gs^Fds, Gs, Gs, Gs^Br\, Gs^Br/, Gs^Br|, Gs^Fds, Gs^Fds, Gs^Fds, Gs^Fds
Gd, Gd, Gd, Gd, Gd, Gs^Fds, Gd, Gd, Hh, Gd, Gd, Gd^Gvs, Mm, Mm, Mm^Xm, Mm, Mm, Gs, Gs, Gs^Br|, Gs^Fds, Gs, Gs^Fds, Gs^Fds, Gs^Fds, Gs^Fds
Gd, Gd, Gs, Gd, Gd, Gd, Gd, Gd, Gd, Gd, Gd, Gs^Fds, Mm, Mm^Xm, Mm^Xm, Mm^Xm, Mm, Gs, Gs^Br/, Gs^Br|, Gs^Fds, Gs^Fds, Gs^Fds, Gs^Fds, Gs^Fds, Gs^Fds
Gs, Gs, Gs, Gs, Gs^Fds, Gd, Gd, Gd, Gd, Gd, Wwt, Wwt, Wwt, Mm, Mm, Mm, Rb^Br/, Rb^Br/, Rb, Rb^Br|, Rb^Br\, Gs^Fds, Hh, Gs^Fds, Gs^Fds, Gs^Fds
Gs, Gs, Gs, Gs, Gs, Gd, Gd, Gd, Hh, Gd, Gd, Wwt, Wwt, Wwt, Rb, Rb^Br/, Rb, Rb, Hh, Hh, Gs^Fds, Hh, Hh, Gs^Fds, Gs^Fds, Gs^Fds
Gs, Gs, Gs, Gs, Gs, Gs, Mm, Hh, Hh, Hh, Gd, Gs^Fds, Wwt, Wwt, Wwt, Rb, Rb, Hh, Rb, Rb, Rb, Rb, Gs^Fds, Gs^Fds, Gs^Fds, Gs^Fds
Gs, Gs, Gs^Br/, Gs^Br/, Mm, Mm, Mm^Xm, Mm, Mm, Gd, Gs, Gs, Wwt, Wwt, Wwt, Gs^Fds, Rb, Hh, Rb, Rb, Rb, Rb, Gs^Fds, Gs^Fds, Gs^Fds, Gs^Fds
Gs^Fds, Gs, Gs^Br|, Mm, Mm, Mm^Xm, Mm^Xm, Mm^Xm, Mm, Mm, Gs, Gs, Gs, Wwt, Wwt, Wwt, Rb, Hh, Rb^Br/, Rb, Rb, Hh, Gs^Fds, Gs^Fds, Gs^Fds, Gs^Fds
Gs^Fds, Gs^Fds, Gs^Fds, Gs^Br\, Gs, Mm, Mm, Mm, Gs, Gs, Gs, Gs, Gs, Wwt, Wwt, Wwt, Rb, Hh^Br/, Rb, Hh, Rb, Rb, Rb, Gs^Fds, Rb, Gs^Fds
Gs^Fds, Gs^Fds, Gs^Fds, Gs^Br|, Gs^Br\, Gs, Gs^Br\, Gs, Gs^Br\, Gs^Tfd, Gs^Fds, Gs, Gs, Wwt, Wwt, Wwt, Wwt, Hh, Hh, Rb, Rb, Rb, Hh, Rb, Mm, _s
Gs^Fds, Gs^Fds, Gs^Fds, Gg, Gs, Gs^Br/, Gs, Gs^Br/, Gs, Gs, Gs, Gs, Hh, Gs^Br|, Wwt, Wwt, Wwt^Bsb/, Gg^Bsb/, Gg, Hh, Hh, Rb, Mm, Mm, Mm^Xm, Mm
Gs^Fds, Gs^Fds, Gs^Fds, Gs^Fds, Gs^Fds, Gs, Gs, Gs, Gs^Fds, Gs, Gs, Gs, Gs, Gs^Br\, Gs^Br/, Wwt^Bsb/, Wwt, Wwt, Wwt, Wwt, Wwt, Hh, Hh, Mm, Mm, Mm
Gs^Fds, Gs^Fds, Gs^Fds, Gs^Fds, Gs^Fds, Gs, Gs, Gs, Gs, Gs, Gs^Fds, Gs^Fds, Gs^Fds, Gs^Fds, Gs^Fds, Gs^Fds, Gs^Fds, Wwt, Wwt, Wwt, Wwt, Wwt, Wwt, Hh, Rb, Rb
Gs^Fds, Gs^Fds, Gs^Fds, Gs^Fds, Gs^Fds, Gs, Gs, Gs, Gs, Gs^Fds, Gs^Fds, Gs^Fds, Gs^Fds, Gs^Fds, Gs^Fds, Gs^Fds, Gs^Fds, Gs^Fds, Gg, Gg, Gg, Wwt, Wwt, Wwt, Wwt, Rb
