border_size=1
usage=map

Gll^Ftr, Gll^Ftr, Gll^Ftr, Gll^Ftr, Ss, Gll^Ftr, Ss, Ss, Gg, Mm, Mm^Xm, Mm^Xm, Mm^Xm, Mm^Xm, Mm^Xm, Mm^Xm, Mm^Xm, Mm^Xm, Mm^Xm, Mm^Xm, Mm^Xm, Mm^Xm, Mm^Xm, Mm^Xm, Mm^Xm, Mm^Xm, Mm^Xm, Mm^Xm, Mm^Xm, Mm^Xm, Mm^Xm, Mm^Xm, Mm^Xm, Mm^Xm, Mm^Xm, Mm^Xm, Mm^Xm, Mm^Xm, Mm^Xm, Mm^Xm, Mm^Xm, Mm^Xm, Mm^Xm, Mm^Xm, Mm^Xm, Mm^Xm
Ss, Ss, Ss, Ss, Ss, Gll^Ftr, Ss, Gg, Gg, Mm, Mm, Mm^Xm, Mm^Xm, Mm^Xm, Mm^Xm, Mm^Xm, Mm^Xm, Mm^Xm, Mm^Xm, Mm^Xm, Mm^Xm, Mm^Xm, Mm^Xm, Mm^Xm, Mm^Xm, Mm^Xm, Mm^Xm, Mm^Xm, Mm^Xm, Mm^Xm, Mm^Xm, Mm^Xm, Mm^Xm, Mm^Xm, Mm^Xm, Mm^Xm, Mm^Xm, Mm^Xm, Mm^Xm, Mm^Xm, Mm^Xm, Mm^Xm, Mm^Xm, Mm^Xm, Mm^Xm, Mm^Xm
Ss, Ss, Ss, Ss, Ss, Ss, Gg, Gg, Gll^Ftr, Gg, Gg, Mm, Mm^Xm, Mm^Xm, Mm^Xm, Mm^Xm, Mm^Xm, Mm^Xm, Mm^Xm, Mm^Xm, Mm^Xm, Mm^Xm, Mm^Xm, Mm^Xm, Mm^Xm, Mm^Xm, Mm^Xm, Mm^Xm, Mm^Xm, Mm^Xm, Mm^Xm, Mm^Xm, Mm^Xm, Mm^Xm, Mm^Xm, Mm^Xm, Mm^Xm, Mm^Xm, Mm^Xm, Mm^Xm, Mm^Xm, Mm^Xm, Mm^Xm, Mm^Xm, Mm^Xm, Mm^Xm
Gll^Ftr, Ss, Gll^Ftr, Ss, Gll^Ftr, Ss, Gg, Gg, Gll^Ftr, Gll^Ftr, Gg, Mm, Mm^Xm, Mm^Xm, Mm^Xm, Mm^Xm, Mm^Xm, Mm^Xm, Mm^Xm, Mm^Xm, Mm^Xm, Mm^Xm, Mm^Xm, Mm^Xm, Mm^Xm, Mm^Xm, Mm^Xm, Mm^Xm, Mm^Xm, Mm^Xm, Mm^Xm, Mm^Xm, Mm^Xm, Mm^Xm, Mm^Xm, Mm^Xm, Mm^Xm, Mm^Xm, Mm^Xm, Mm^Xm, Mm^Xm, Mm^Xm, Mm^Xm, Mm^Xm, Mm^Xm, Mm^Xm
Gll^Ftr, Gll^Ftr, Hh^Ft, Ss, Ss, Ss, Gg, Gg, Gg, Gg, Gg, Mm, Mm^Xm, Mm^Xm, Mm^Xm, Mm^Xm, Mm^Xm, Mm^Xm, Mm^Xm, Mm^Xm, Mm^Xm, Mm^Xm, Mm^Xm, Mm^Xm, Mm^Xm, Mm^Xm, Mm^Xm, Mm^Xm, Mm^Xm, Mm^Xm, Mm^Xm, Mm^Xm, Mm^Xm, Mm^Xm, Mm^Xm, Mm^Xm, Mm^Xm, Mm^Xm, Mm^Xm, Mm^Xm, Mm^Xm, Mm^Xm, Mm^Xm, Mm^Xm, Mm^Xm, Mm^Xm
Gg, Hh^Ft, Gg, Gg, Gg, Gg, Gg, Gg, Gg, Gll^Ftr, Gg, Mm, Mm, Mm^Xm, Mm^Xm, Mm^Xm, Mm^Xm, Mm^Xm, Mm^Xm, Mm^Xm, Mm^Xm, Mm^Xm, Mm^Xm, Mm^Xm, Mm^Xm, Mm^Xm, Mm^Xm, Mm^Xm, Mm^Xm, Mm^Xm, Mm^Xm, Mm^Xm, Mm, Mm^Xm, Mm, Mm^Xm, Mm, Mm^Xm, Mm^Xm, Mm^Xm, Mm^Xm, Mm^Xm, Mm^Xm, Mm^Xm, Mm^Xm, Mm^Xm
Gll^Ftr, Gg, Gg, Hh^Ft, Gg, Gg, Gg, Gg, Gg, Gg, Gg, Gg, Gg, Mm, Mm, Mm^Xm, Mm^Xm, Mm^Xm, Mm^Xm, Mm^Xm, Mm^Xm, Mm^Xm, Mm^Xm, Mm^Xm, Mm, Mm, Mm, Mm, Mm, Mm, Mm, Rrc, Rrc, Mm, Rd, Mm, Rd, Mm, Mm, Mm^Xm, Mm^Xm, Mm^Xm, Mm^Xm, Mm^Xm, Mm^Xm, Mm^Xm
Gll^Ftr, Gll^Ftr, Gg, Hh^Ft, Gg, Gg, Gg, Gg, Hh^Ft, Gg, Gg, Gg, Gg, Hh^Ft, Hh^Ft, Mm, Mm, Wwg, Mm, Mm, Mm, Mm^Xm, Mm, Mm, Rd, Rrc, Rd^Tfd, Rd, Rd, Rd, Rd, Rrc, Rrc, Rrc, Rrc, Rd, Rd, Rd, Mm, Mm, Mm^Xm, Mm^Xm, Mm^Xm, Mm^Xm, Mm^Xm, Mm^Xm
Gll^Ftr, Gll^Ftr, Gg, Gg, Gg, Gg, Gg, Gg, Hh^Ft, Hh^Ft, Gg, Gg, Hh^Ft, Mm, Mm, Mm, Wwg, Wwg, Gg, Gg, Gg, Mm, Mm, Rd, Rd, Rrc, Rd, Rd, Rd, Rd, Rrc, Rrc, Rrc, Rrc, Rd, Rrc, Rrc, Rd, Mm, Mm^Xm, Mm^Xm, Mm^Xm, Mm^Xm, Mm^Xm, Mm^Xm, Mm^Xm
Gll^Ftr, Gll^Ftr, Gg, Gg, Gg, Gg, Hh^Ft, Gg, Gg, Gg, Gg, Gg, Mm, Mm, Mm, Mm, Wwg, Ds, Hh^Ft, Gg, Hh, Gg, Hhd, Rd, Rd, Rrc, Rd, Rd, Rd, Rrc, Rd^Tfd, Rd, Hhd^Tfd, Hhd, Rd, Rd, Mm, Mm, Mm^Xm, Mm^Xm, Mm^Xm, Mm^Xm, Mm^Xm, Mm^Xm, Mm^Xm, Mm^Xm
Gll^Ftr, Gg, Gg, Gg, Gg, Gg, Gg, Gg, Gg, Gg, Gg, Hh^Ft, Hh^Ft, Mm, Hh^Ft, Wwg, Gll^Ftr, Hh^Ft, Gll^Ftr, Gll^Ftr, Gll^Ftr, Hh, Hhd, Rd, Hhd^Tfd, Rrc, Rd, Rd, Rd, Rrc, Rd, Rd, Rd, Hhd, Hhd, Rd, Mm, Mm^Xm, Mm^Xm, Mm^Xm, Mm^Xm, Mm^Xm, Mm^Xm, Mm^Xm, Mm^Xm, Mm^Xm
Gg, Gg, Gg, Hh, Gg, Gg, Gg, Gg, Gg, Gg, Gg, Gg, Gg, Gg, Ds, Wwg, Gll^Ftr, Gll^Ftr, Gll^Ftr, Gll^Ftr, Gll^Ftr, Gll^Ftr, Gll^Ftr, Hhd, Gg^Dr, Hhd, Gg, Gg, Gg, Rrc, Rrc, Rd, Gg, Rd, Rd, Rd^Dr, Mm, Mm^Xm, Mm^Xm, Mm^Xm, Mm^Xm, Mm^Xm, Mm^Xm, Mm^Xm, Mm^Xm, Mm^Xm
Hh, Hh, Hh, Gg, Gg, Gg, Gg, Gg, Gg, Gg, Hh, Gg, Gg, Gg, Ds, Wwg, Gg, Gll^Ftr, Gll^Ftr, Gll^Ftr, Gll^Ftr, Gll^Ftr, Gll^Ftr, Gll^Ftr, Gg, Gg, Gg, Gg^Dr, Gg^Dr, Gg, Rrc, Gg, Gg, Hh, Hh, Gg, Mm, Mm^Xm, Mm^Xm, Mm^Xm, Mm^Xm, Mm^Xm, Mm^Xm, Mm^Xm, Mm^Xm, Mm^Xm
Hh, Hh, Hh, Gg, Gll^Ftr, Gg, Gg, Gll^Ftr, Gg, Hh, Hh, Hh, Gg, Gg, Wwg, Wwg, Gg, Gg, Gll^Ftr, Gll^Ftr, Hh^Ft, Hh^Ft, Gll^Ftr, Gll^Ftr, Hh^Ft, Hh, Gg, Gg, Gg, Gg, Rrc, Gg, Hh, Hh, Gg, Gg, Mm, Mm^Xm, Mm^Xm, Mm^Xm, Mm^Xm, Mm^Xm, Mm^Xm, Mm^Xm, Mm^Xm, Mm^Xm
Gll^Ftr, Gg, Gg, Gg, Gg, Gg, Gg, Gll^Ftr, Hh, Hh, Hh, Gg, Ds, Wwg, Ds, Ds, Gg, Gg, Gg, Gll^Ftr, Gg, Gg, Gg, Hh^Ft, Gg, Hh, Gg, Gg, Gg, Gg, Rrc, Gg, Gg, Gg, Gg, Gg, Gg, Mm, Mm^Xm, Mm^Xm, Mm^Xm, Mm^Xm, Mm^Xm, Mm^Xm, Mm^Xm, Mm^Xm
Gg, Gll^Ftr, Gg, Gg, Gg, Gll^Ftr, Gg, Gg, Gg, Hh, Gg, Ds, Wwg, Wwg, Gg, Gg, Gg, Gg, Gg, Gg, Gg^Gvs, Gg^Gvs, Gg^Gvs, Gg, Gg^Gvs, Gg, Gg, Gg, Gg, Gg, Gg, Rrc, Rrc, Gg, Gg, Gg, Gg, Mm, Mm, Mm^Xm, Mm^Xm, Mm^Xm, Mm^Xm, Mm^Xm, Mm^Xm, Mm^Xm
Gll^Ftr, Gg, Hh, Gg, Gg, Gg, Gg, Gg, Gg, Gg, Ds, Wwg, Gg, Gg, Gg, Gg, Gg, Gg, Gg, Gg, Gg^Gvs, Gg^Gvs, Gg^Gvs, Gg^Gvs, Gg^Gvs, Gg^Gvs, Gg, Hh, Hh, Hh, Gg, Gg, Rrc, Gg, Gg, Gg, Gg, Gg, Rd, Rd, Mm^Xm, Mm^Xm, Mm^Xm, Mm^Xm, Mm^Xm, Mm^Xm
Hh, Hh, Hh, Gg, Gg, Gg, Gg, Gg, Gll^Ftr, Gg, Wwg, Wwg, Gg, Gg, Gg, Gg, Gg, Gg, Gll^Ftr, Gg, Gg, Gg^Gvs, Gg^Gvs, Gg^Gvs, Gg^Gvs, Gg^Gvs, Gg, Gg, Hh, Gg, Gg, Gg, Rrc, Gg, Gg, Gg, Gg, Rd, Rd, Rd, Rd, Mm^Xm, Gg, Mm^Xm, Mm^Xm, Mm^Xm
Hh, Hh, Hh, Gg, Gll^Ftr, Gg, Gg, Gg, Gll^Ftr, Gg, Wwg, Gg, Gg, Gg, Gg, Gg, Gg, Gg, Gll^Ftr, Gll^Ftr, Gll^Ftr, Gg, Gg, Gg^Gvs, Gg^Gvs, Gg^Gvs, Gg, Hh, Gg, Gg, Gg, Gg, Rrc, Gg, Gg, Gg, Gll^Ftr, Rd, Rd, Rd, Mv, Gg, Gg, Mm^Xm, Mm^Xm, Mm^Xm
Hh, Hh, Gg, Gg, Gll^Ftr, Gg, Gg, Gll^Ftr, Gg, Gg, Wwg, Gg, Gg, Gg, Mm, Mm, Mm, Gg, Gll^Ftr, Gll^Ftr, Gg, Gg, Gg, Gg^Gvs, Gg, Gg^Gvs, Gg^Gvs, Gg, Gll^Ftr, Gg, Gll^Ftr, Gg, Rrc, Gg, Gll^Ftr, Gll^Ftr, Gg, Gg, Gg, Mm, Mm, Mm, Gg, Gg, Gg, Mm^Xm
Gg, Hh, Hh, Gg, Gg, Gg, Wwg, Gg, Ds, Ds, Wwg, Gg, Gg, Mm, Gg, Mm, Gg, Gg, Gg, Gll^Ftr, Gll^Ftr, Gll^Ftr, Gg, Gg^Gvs, Gg^Gvs, Gg^Gvs, Gg, Gg, Gll^Ftr, Gll^Ftr, Gg, Gg, Gll^Ftr, Rrc, Gg, Gll^Ftr, Gll^Ftr, Gll^Ftr, Gg, Gg, Gg, Gg, Gg, Gg, Gg, Gg
Gg, Hh, Gg, Gll^Ftr, Gg, Wwg, Ds, Wwg, Wwg, Wwg, Gg, Gg, Gg, Mm, Mm, Mm, Gg, Gg, Gll^Ftr, Gll^Ftr, Gg, Gll^Ftr, Gg, Gg^Gvs, Gg, Gg, Gll^Ftr, Gg, Gg, Gg, Gg, Gg, Gg, Rrc, Gll^Ftr, Gg, Gg, Gll^Ftr, Gg, Gll^Ftr, Gg, Gg, Gll^Ftr, Gll^Ftr, Gg, Gg
Gll^Ftr, Gg, Gll^Ftr, Gg, Wwg, Wwg, Gg, Gg, Gg, Gg, Gg, Gg, Gg, Gg, Gg, Gg, Ss, Gg, Gg, Gg, Gll^Ftr, Gg, Gg, Gg, Gll^Ftr, Gg, Gg, Gg, Gg, Gll^Ftr, Gg, Gg, Rrc, Rrc, Gg, Gll^Ftr, Gg, Gg, Gg, Gg, Gll^Ftr, Gg, Gll^Ftr, Gll^Ftr, Gg, Gg
Gll^Ftr, Gll^Ftr, Gg, Wwg, Ds, Gg, Mm, Mm, Mm, Gg, Mm, Gg, Mm, Gg, Gg, Gg, Ss, Ss, Gg, Gll^Ftr, Gll^Ftr, Gg, Gg, Gg, Gg, Gg, Gg, Gll^Ftr, Gg, Gll^Ftr, Rrc, Rrc, Ss, Gg, Gg, Gg, Gg, Gll^Ftr, Gg, Gll^Ftr, Gll^Ftr, Gg, Gg, Gg, Ss, Ss
Gg, Gll^Ftr, Gg, Wwg, Ds, Gg, Mm, Mm, Mm, Gg, Gg, Gg, Mm, Mm, Gg, Gg, Gg, Ss, Ss, Gg, Gll^Ftr, Gg, Mm, Gg, Gg, Gll^Ftr, Gg, Gg, Rrc, Rrc, Gll^Ftr, Gg, Gg, Gg, Ss, Gg, Gll^Ftr, Gg, Gll^Ftr, Gg, Gll^Ftr, Gg, Ss, Ss, Ss, Ss
Gg, Gll^Ftr, Gg, Wwg, Wwg, Gg, Gg, Gg, Gg, Gg, Gg, Mm, Gg, Mm, Gg, Gg, Gg, Gg, Gg, Gg, Gg, Gg, Mm, Mm, Mm, Gg, Gg, Gg, Rrc, Rrc, Gg, Gg, Gg, Ss, Gg, Gg, Gg, Gg, Gg, Gg, Gg, Gg, Ss, Ss, Ss, Ss
Gll^Ftr, Gll^Ftr, Gll^Ftr, Gg, Wwg, Gg, Gg, Gg, Gg, Gg, Gg, Gg, Gg, Gg, Gg, Gg, Hh, Gg, Gg, Gg, Gg, Gg, Mm, Mm, Mm, Gg, Gg, Gg, Mm, Gg, Mm, Mm, Mm, Gg, Gg, Gll^Ftr, Gll^Ftr, Gg, Gg, Gg, Ss, Ss, Gg, Ss, Ss, Ss
Gll^Ftr, Gg, Gg, Gg, Wwg, Gg, Gg, Gg, Hh, Hh, Hh, Gg, Gg, Gg, Gg, Hh, Hh, Gg, Gg, Hh, Gg, Gg, Gg, Mm, Mm, Mm, Gg, Mm, Mm, Mm, Hh, Mm, Gg, Gg, Gg, Gg, Gg, Gg, Gg, Gg, Gg, Gg, Gg, Gg, Ss, Ss
Gg, Gg, Gg, Ds, Wwg, Gg, Gg, Gg, Gg, Hh, Gg, Hh, Gg, Hh, Gg, Gg, Gg, Hh, Gg, Gg, Gg, Gg, Gg, Gg, Hh, Hh, Hh, Gg, Hh, Gg, Hh, Gg, Gg, Ss, Ss, Ss, Gg, Ss, Ss, Gg, Gg, Gg, Ss, Ss, Ss, Ss
Gll^Ftr, Gll^Ftr, Gg, Wwg, Ds, Gg, Gg, Gg, Gg, Gg, Gg, Gg, Gg, Gg, Gg, Gg, Gg, Gg, Gg, Gg, Gg, Gg, Gg, Gg, Hh, Hh, Hh, Hh, Hh, Gg, Gg, Gg, Ss, Ss, Gg, Ss, Ss, Ss, Ss, Gg, Gg, Gg, Gg, Gg, Ss, Ss
